Amy : jfci
Ian : quck
Lee : hdhq
Jon : xpdh
Joe : mkre
Jay : vwad
Ana : aqox
Ann : zhxy
Roy : wcci
Joy : oxps
Tia : jgli
Ray : oiar
Max : jhdc
Eva : mzim
Eli : hxem
Mia : cbmq
Don : winb
Leo : kdpv
Ben : ttra
Ivy : tzsy
Lea : mgqj
Guy : udyl
Ty : udcy
Sam : wdjd
Kim : djsr
Luz : bxsu
Ali : hghz
Ted : pykg
Dan : pana
Noe : nmsd
Rex : hphp
Kia : gugq
Jim : qgrz
Zoe : obir
Ami : twsm
Tom : bpmn
Ron : mqav
Mai : yhba
Jo : qzfb
Lia : cwnp
Ada : jjmu
Ira : jpve
Aja : srbp
Nia : rblc
Ida : vtuj
Bo : xxoy
Eve : izbq
Jed : xclt
Van : ybmf
Asa : tbzp
Sue : aanh
Kay : xbcx
May : vvbr
Ava : fvua
Tad : ltnw
Jan : ljgf
Ari : kbmw
Coy : iekh
Ken : uevb
Rae : efmy
Tim : pxfa
Joi : jqys
Kai : dolv
Al : jnpb
Kip : yxuq
Tye : kxow
Bob : mtrg
Rey : bpgg
Pia : nuzu
Tou : dmge
Huy : qpza
Hal : ezel
Liz : agmx
Mae : gras
Gia : xzcg
Anh : otiu
Ned : ojlp
Tj : ledo
Sky : dujj
My : mtit
Mya : demc
Nam : ztyp
Jeb : fnto
Gus : crdd
Ean : ylrd
Gil : zrfi
Pa : tpva
Ike : qbkn
Avi : lehd
Aj : umqe
Vu : gywt
Ina : tmsh
Wes : hahw
Dru : jvay
Hai : jepn
Tai : pdwp
Duy : xqir
Meg : sxra
Mac : witn
Lon : ykpf
Bud : fcxn
Dov : qlqv
Cal : zowv
Tam : suig
Von : yarp
Thu : uoig
Ora : gxqr
Son : yrdc
Kc : ggux
Ely : gcim
Dax : zjwz
Yen : rwwd
Ka : zbgd
Fay : uwhs
Cy : akbw
Ace : uiex
Ren : rlns
Jai : eikl
Dee : tans
Bao : cwge
La : ienk
Job : pvib
Tan : rbpq
Taj : lqkk
Sal : bynv
Rob : rvpt
Kou : uvjs
Iva : mlkr
Dia : smhe
An : eddw
Wm : kfnx
Rod : scrc
Lan : yyct
Jd : dreg
Ed : ihtx
Kye : yabf
Abe : vkfi
Nga : iprw
Vy : qfji
Vi : zlpp
Kit : cioy
Ha : tyva
Del : wnqi
Any : hgte
Yer : rkcu
Ria : jtxz
Raj : matf
Len : qayq
Jc : uuhx
Hoa : wxge
Chi : wimm
Ani : wvfd
Zev : xkad
Toi : uxtv
Jae : ahqa
Bee : lbzm
Rio : qgyf
Les : vsqj
Ky : jhzq
Ara : iuaa
Tod : rfiu
Pat : tjks
Che : akyf
Sol : tljq
See : mjya
Le : smdp
Lam : sftp
Isa : qqcs
Ibn : otbk
Tri : ywpi
Mi : mupe
Mee : bkxj
Lou : jqgg
Fue : xarx
Emi : bmfx
Duc : jrxw
Tu : zhpn
Sy : bpng
Lyn : pbxh
Ema : ztsx
Dex : sjdr
De : dabm
Zak : rywq
Sir : lmml
Pao : qfsz
Mei : gnyu
Dj : sytx
Yee : zfwg
Val : hwov
Ric : pfgi
Ona : ycwj
Ly : ugug
Kea : wqaw
Ila : uvql
Bj : kuyw
Uri : nytg
San : qfgh
Ola : frhh
Lex : akfb
Jin : hklr
Ger : ayyq
Gao : xyjj
Ena : errx
Aya : biap
Art : xiqi
Thy : fdpf
Mao : emca
Ma : vyab
Lue : xmnt
Kao : emnz
Jr : fhch
Zeb : pyoz
Zac : cvzb
Tal : jitf
Phi : ecny
Nou : yrxc
Eun : luhu
Dea : megi
Yul : byvf
Yan : rxco
Tya : scrp
Thi : eakm
Ry : cuxz
Rut : pmux
Jun : cvcw
Ji : bymq
Dat : quci
Dai : psgv
Zan : nkxn
Yu : hckb
Wil : aokr
Vic : xttk
Tel : wxtq
Rj : fqao
Rea : zdsg
Min : gywi
Lin : mlkc
Jw : qmqq
Joh : rgos
Jad : uicl
Emy : vmab
Eda : scyj
Boy : zyeq
Boe : etub
Sok : gtkr
Oma : bnnb
Nan : sijw
Na : bbcn
Mel : dopf
Man : vbyc
Luc : jrdb
Lc : bevc
Jyl : gcsp
Jb : hqoy
Era : gbyp
Dam : rdnl
Cj : rltv
Cam : lzpe
Ame : kcea
Zed : jjvx
Yun : cgfb
Xue : plus
Tin : jzmj
Tho : hzpc
Soo : csmf
Sai : svux
Nhi : mayi
Mar : crjv
Lus : yxir
Lai : wrsi
Kym : fbgy
Kya : fvpx
Kal : utve
Jen : txan
Hue : itvd
Han : kluf
Dal : bysv
Ala : hlqj
Adi : vpmf
Yaa : zfmh
Tee : jovn
Sun : ifpy
Su : atov
Sia : gpzz
Sha : wfkm
Pj : yuqg
Pam : xcbr
Pal : zhzx
Nhu : rdvy
Nai : vtax
Mrk : ozzw
Liv : ncxo
Lev : iufs
Jua : cdgo
Jt : jieb
Jes : ouml
Gem : cyyo
Eon : fiho
Aul : qxxg
Aki : lavb
Zvi : fpwt
Zer : bavp
Wei : mjjw
Wa : vbpb
Va : xuva
Una : spqh
Tae : blja
Sou : seqi
Rui : mtdx
Rik : gsov
Reo : jjev
Rad : gqnd
Noa : tcox
Lor : kggj
Lao : eylc
Kue : aldx
Kei : zyui
Evy : ygsz
Eri : ghon
Ein : lcvo
Doc : zyjd
Dao : oikk
Cha : vsce
Bon : riha
Ave : yity
Ary : ulqm
Ai : znqd
Abu : jebg
Yon : bjnm
Xia : dgqh
Won : erfq
Wai : kdhh
Vue : iwib
Tre : xktm
Tej : dqqq
Tab : sgxf
So : toqn
Sid : drrk
Sea : nkgl
Ryo : dslc
Rye : bqcx
Rya : vzbu
Ram : gxrc
Qui : ttom
Paz : zmin
Ory : arvs
Ohn : dzda
Nya : bdsv
Nik : jymx
Mir : vidn
Lei : emjo
Kaj : pmeh
Kae : cuee
Ife : nxln
Icy : ldex
Ia : akpq
Hau : zyst
Hao : awbr
Hae : qoud
Edi : wygk
Der : jcml
Da : abnf
Ayn : auue
Ark : aioo
Ane : jnjc
Amr : ydyk
Ama : bvur
Aly : yjyo
Abi : altz
Zia : zvhq
Yaw : nzje
Ugo : ztow
Toy : ughv
Tor : xjzc
Tex : xxxp
Taz : lveg
Ta : cxxu
Sim : ruyy
Sho : rpbw
Ryu : dstw
Ruy : nyxs
Rc : begh
Phu : wtxc
Per : syll
Naa : bgkd
Me : zxzn
Mea : mnuk
Mat : ybvx
Lu : kjuw
Li : xqut
Ko : bljp
Ki : mszu
Kha : zyms
Keo : dmju
Kee : pfrt
Kam : dmpr
Jud : iofa
Jl : qnks
Jia : hbbs
Ita : fkdx
Her : ihrd
Ewa : hdsd
Esi : dnbx
Ej : balu
Edy : rvwf
Edd : ydsk
Cas : dudw
Can : mdyy
Bri : tklv
Bre : tzid